3 4 0 0 0
3 4 3 2 2
1 2 1 2 1
0 3 4 0 3
1 3 3 1 0
3 2 1 0 1
0 0 2 2 2
3 3 4 4 0
3 2 0 4 2
0 2 3 3 0
